


  R 800 800
 NO   images/greystone.xpm
   SO ./images/mossy.xpm
EA ./images/colorstone.xpm
WE ./images/wood.xpm
 S  ./images/barrel.xpm

F   220,100,120


  C 40,1,250


11111111111111111111
11111000002200020011111
10000022000000200000001
1000020000W000020000111
11111111111111111111111