


  R 800 800
 NO    images/greystone.xpm
   SO ./images/redbrick.xpm
EA ./images/colorstone.xpm
WE ./images/wood.xpm
 S  ./images/barrel.xpm  
 
F   220,100,21


  C 40,30,250

        1111111111111111111111111
        1000000000110000012100001
        1011000001110020000000001
        100100000000000000N000001
111111111011000001110000000000001
100000000011000001110111111111111
11110111111111011100000010001
11110111111111011101010010001
11000000110101011100000010001
10000000000000001100000010001
10020000000000001101010010001
1100000111010101111101111000111
11110111 1110101 101111010001
11111111 1111111 111111111111
    

