


 R 800 800
 NO ./images/bluestone.xpm
   SO ./images/mossy.xpm
 EA  ./images/colorstone.xpm
WE ./images/wood.xpm
 S  ./images/barrel.xpm

  F 200                ,                    100, 120


  C 40,1,250


11111111111111111111
11111000002200020011111
10000000000000000000001
10000022000000200000001
10000022000000220000001
1000002200E000200000001
1000002200000020x000001
10000200001000020000111
11111111111111111111111
